25 40
  #######################
  #.....................#
  #.....................#
  #######...............#
        #...............#
  #######...............#
  #.....................#
  #.....................#
  #.....#################
  #.....#
  #.....#################
  #.....................#
  #.....................#
  #######...............#
        #...............#
  #######...............#
  #.....................#
  #.....................#
  #.....................#
  #......################
  #......#
  #......#
  #......#
  #......#
  #......#
  #......#
  #......################
  #.....................#
  #.....................#
  #######...............#
        #...............#
  #######...............#
  #.....................#
  #.....................#
  #.....................#
  #.....................#
  #.....................#
  #.....................#
  #.....................#
  #######################