25 40
  ####################
  #...........@......#
  #..................#
  #######............#
        #............#
  #######............#
  #..................#
  #..................#
  #.....##############
  #.....#
  #.....##############
  #..................#
  #..................#
  #######............#
        #............#
  #######............#
  #..................#
  #..................#
  #..................#
  #......#############
  #......#
  #......#
  #......#
  #......#
  #......#
  #......#
  #......#############
  #..................#
  #..................#
  #######............#
        #............#
  #######............#
  #..................#
  #..................#
  #..................#
  #..................#
  #..................#
  #..................#
  #..................#
  ####################