28 40
  ##########################
  #...........@............#
  #........................#
  #######..................#
        #..................#
  #######..................#
  #........................#
  #........................#
  #.....####################
  #.....#
  #.....##############
  #..................#
  #..................#
  #######............#
        #............#
  #######............#
  #..................#
  #..................#
  #..................#
  #......#############
  #......#
  #......#
  #......#
  #......#
  #......#
  #......#
  #......#############
  #..................#
  #..................#
  #######............#
        #............#
  #######............#
  #..................#
  #..................#
  #..................#
  #..................#
  #..................#
  #..................#
  #..................#
  ####################